10, 9*
ODOOOSOOOO
ODOOOSOOOO
ODOOOSOOOO
ODOOOSOOOO
ODOOOSOOOO
ODODDSOOOB
OOOOOOOOOO
OOOOOOOOOO
OO1OOOOOOO