10, 9*
ODOOOSOOOO
ODOOOSOOOO
ODOOOSOOOO
ODOOOSOOOO
ODOOOSOOOO
ODODDSOOOO
OO1OOOOOOO
OOOOOOOOOO
O0OOOOO2OO