10, 9*
ODOOOSOOOO
ODOOOSOOOO
ODOOOSOOOO
ODOOOSOOOO
ODOOOSOOOO
ODODDSOOOO
OOOOOOOOOO
OOOOOOOOOO
OOOOOOOOOO